/sentry-debug/	justutorial.urls.trigger_error		
/admin/	django.contrib.admin.sites.index	admin:index	
/admin/login/	django.contrib.admin.sites.login	admin:login	
/admin/logout/	django.contrib.admin.sites.logout	admin:logout	
/admin/password_change/	django.contrib.admin.sites.password_change	admin:password_change	
/admin/password_change/done/	django.contrib.admin.sites.password_change_done	admin:password_change_done	
/admin/jsi18n/	django.contrib.admin.sites.i18n_javascript	admin:jsi18n	
/admin/r/<content_type_id>/<object_id>/	django.contrib.contenttypes.views.shortcut	admin:view_on_site	
/admin/account/emailaddress/	django.contrib.admin.options.changelist_view	admin:account_emailaddress_changelist	
/admin/account/emailaddress/add/	django.contrib.admin.options.add_view	admin:account_emailaddress_add	
/admin/account/emailaddress/<var>/history/	django.contrib.admin.options.history_view	admin:account_emailaddress_history	
/admin/account/emailaddress/<var>/delete/	django.contrib.admin.options.delete_view	admin:account_emailaddress_delete	
/admin/account/emailaddress/<var>/	django.contrib.admin.options.change_view	admin:account_emailaddress_change	
/admin/enunciado/localidade/	django.contrib.admin.options.changelist_view	admin:enunciado_localidade_changelist	
/admin/enunciado/localidade/add/	django.contrib.admin.options.add_view	admin:enunciado_localidade_add	
/admin/enunciado/localidade/<var>/history/	django.contrib.admin.options.history_view	admin:enunciado_localidade_history	
/admin/enunciado/localidade/<var>/delete/	django.contrib.admin.options.delete_view	admin:enunciado_localidade_delete	
/admin/enunciado/localidade/<var>/	django.contrib.admin.options.change_view	admin:enunciado_localidade_change	
/admin/enunciado/enunciadopropostadiscursiva/<pk>/copiar_enunciado/	apps.enunciado.admin.copiar_enunciado		
/admin/enunciado/enunciadopropostadiscursiva/	django.contrib.admin.options.changelist_view	admin:enunciado_enunciadopropostadiscursiva_changelist	
/admin/enunciado/enunciadopropostadiscursiva/add/	django.contrib.admin.options.add_view	admin:enunciado_enunciadopropostadiscursiva_add	
/admin/enunciado/enunciadopropostadiscursiva/<var>/history/	django.contrib.admin.options.history_view	admin:enunciado_enunciadopropostadiscursiva_history	
/admin/enunciado/enunciadopropostadiscursiva/<var>/delete/	django.contrib.admin.options.delete_view	admin:enunciado_enunciadopropostadiscursiva_delete	
/admin/enunciado/enunciadopropostadiscursiva/<var>/	django.contrib.admin.options.change_view	admin:enunciado_enunciadopropostadiscursiva_change	
/admin/auth/group/	django.contrib.admin.options.changelist_view	admin:auth_group_changelist	
/admin/auth/group/add/	django.contrib.admin.options.add_view	admin:auth_group_add	
/admin/auth/group/<var>/history/	django.contrib.admin.options.history_view	admin:auth_group_history	
/admin/auth/group/<var>/delete/	django.contrib.admin.options.delete_view	admin:auth_group_delete	
/admin/auth/group/<var>/	django.contrib.admin.options.change_view	admin:auth_group_change	
/admin/enunciado/esferaespecifica/	django.contrib.admin.options.changelist_view	admin:enunciado_esferaespecifica_changelist	
/admin/enunciado/esferaespecifica/add/	django.contrib.admin.options.add_view	admin:enunciado_esferaespecifica_add	
/admin/enunciado/esferaespecifica/<var>/history/	django.contrib.admin.options.history_view	admin:enunciado_esferaespecifica_history	
/admin/enunciado/esferaespecifica/<var>/delete/	django.contrib.admin.options.delete_view	admin:enunciado_esferaespecifica_delete	
/admin/enunciado/esferaespecifica/<var>/	django.contrib.admin.options.change_view	admin:enunciado_esferaespecifica_change	
/admin/cupom/cupommassa/	django.contrib.admin.options.changelist_view	admin:cupom_cupommassa_changelist	
/admin/cupom/cupommassa/add/	django.contrib.admin.options.add_view	admin:cupom_cupommassa_add	
/admin/cupom/cupommassa/<var>/history/	django.contrib.admin.options.history_view	admin:cupom_cupommassa_history	
/admin/cupom/cupommassa/<var>/delete/	django.contrib.admin.options.delete_view	admin:cupom_cupommassa_delete	
/admin/cupom/cupommassa/<var>/	django.contrib.admin.options.change_view	admin:cupom_cupommassa_change	
/admin/enunciado/resposta/	django.contrib.admin.options.changelist_view	admin:enunciado_resposta_changelist	
/admin/enunciado/resposta/add/	django.contrib.admin.options.add_view	admin:enunciado_resposta_add	
/admin/enunciado/resposta/<var>/history/	django.contrib.admin.options.history_view	admin:enunciado_resposta_history	
/admin/enunciado/resposta/<var>/delete/	django.contrib.admin.options.delete_view	admin:enunciado_resposta_delete	
/admin/enunciado/resposta/<var>/	django.contrib.admin.options.change_view	admin:enunciado_resposta_change	
/admin/socialaccount/socialaccount/	django.contrib.admin.options.changelist_view	admin:socialaccount_socialaccount_changelist	
/admin/socialaccount/socialaccount/add/	django.contrib.admin.options.add_view	admin:socialaccount_socialaccount_add	
/admin/socialaccount/socialaccount/<var>/history/	django.contrib.admin.options.history_view	admin:socialaccount_socialaccount_history	
/admin/socialaccount/socialaccount/<var>/delete/	django.contrib.admin.options.delete_view	admin:socialaccount_socialaccount_delete	
/admin/socialaccount/socialaccount/<var>/	django.contrib.admin.options.change_view	admin:socialaccount_socialaccount_change	
/admin/quizz/bloco/	django.contrib.admin.options.changelist_view	admin:quizz_bloco_changelist	
/admin/quizz/bloco/add/	django.contrib.admin.options.add_view	admin:quizz_bloco_add	
/admin/quizz/bloco/<var>/history/	django.contrib.admin.options.history_view	admin:quizz_bloco_history	
/admin/quizz/bloco/<var>/delete/	django.contrib.admin.options.delete_view	admin:quizz_bloco_delete	
/admin/quizz/bloco/<var>/	django.contrib.admin.options.change_view	admin:quizz_bloco_change	
/admin/curso/atividade/	django.contrib.admin.options.changelist_view	admin:curso_atividade_changelist	
/admin/curso/atividade/add/	django.contrib.admin.options.add_view	admin:curso_atividade_add	
/admin/curso/atividade/<var>/history/	django.contrib.admin.options.history_view	admin:curso_atividade_history	
/admin/curso/atividade/<var>/delete/	django.contrib.admin.options.delete_view	admin:curso_atividade_delete	
/admin/curso/atividade/<var>/	django.contrib.admin.options.change_view	admin:curso_atividade_change	
/admin/aluno/mensagem/	django.contrib.admin.options.changelist_view	admin:aluno_mensagem_changelist	
/admin/aluno/mensagem/add/	django.contrib.admin.options.add_view	admin:aluno_mensagem_add	
/admin/aluno/mensagem/<var>/history/	django.contrib.admin.options.history_view	admin:aluno_mensagem_history	
/admin/aluno/mensagem/<var>/delete/	django.contrib.admin.options.delete_view	admin:aluno_mensagem_delete	
/admin/aluno/mensagem/<var>/	django.contrib.admin.options.change_view	admin:aluno_mensagem_change	
/admin/curso/sentencaavulsa/	django.contrib.admin.options.changelist_view	admin:curso_sentencaavulsa_changelist	
/admin/curso/sentencaavulsa/add/	django.contrib.admin.options.add_view	admin:curso_sentencaavulsa_add	
/admin/curso/sentencaavulsa/<var>/history/	django.contrib.admin.options.history_view	admin:curso_sentencaavulsa_history	
/admin/curso/sentencaavulsa/<var>/delete/	django.contrib.admin.options.delete_view	admin:curso_sentencaavulsa_delete	
/admin/curso/sentencaavulsa/<var>/	django.contrib.admin.options.change_view	admin:curso_sentencaavulsa_change	
/admin/autor/disciplinaconcurso/	django.contrib.admin.options.changelist_view	admin:autor_disciplinaconcurso_changelist	
/admin/autor/disciplinaconcurso/add/	django.contrib.admin.options.add_view	admin:autor_disciplinaconcurso_add	
/admin/autor/disciplinaconcurso/<var>/history/	django.contrib.admin.options.history_view	admin:autor_disciplinaconcurso_history	
/admin/autor/disciplinaconcurso/<var>/delete/	django.contrib.admin.options.delete_view	admin:autor_disciplinaconcurso_delete	
/admin/autor/disciplinaconcurso/<var>/	django.contrib.admin.options.change_view	admin:autor_disciplinaconcurso_change	
/admin/curso/sentencaavulsaaluno/	django.contrib.admin.options.changelist_view	admin:curso_sentencaavulsaaluno_changelist	
/admin/curso/sentencaavulsaaluno/add/	django.contrib.admin.options.add_view	admin:curso_sentencaavulsaaluno_add	
/admin/curso/sentencaavulsaaluno/<var>/history/	django.contrib.admin.options.history_view	admin:curso_sentencaavulsaaluno_history	
/admin/curso/sentencaavulsaaluno/<var>/delete/	django.contrib.admin.options.delete_view	admin:curso_sentencaavulsaaluno_delete	
/admin/curso/sentencaavulsaaluno/<var>/	django.contrib.admin.options.change_view	admin:curso_sentencaavulsaaluno_change	
/admin/quizz/questao/	django.contrib.admin.options.changelist_view	admin:quizz_questao_changelist	
/admin/quizz/questao/add/	django.contrib.admin.options.add_view	admin:quizz_questao_add	
/admin/quizz/questao/<var>/history/	django.contrib.admin.options.history_view	admin:quizz_questao_history	
/admin/quizz/questao/<var>/delete/	django.contrib.admin.options.delete_view	admin:quizz_questao_delete	
/admin/quizz/questao/<var>/	django.contrib.admin.options.change_view	admin:quizz_questao_change	
/admin/autor/questaogrupo/	django.contrib.admin.options.changelist_view	admin:autor_questaogrupo_changelist	
/admin/autor/questaogrupo/add/	django.contrib.admin.options.add_view	admin:autor_questaogrupo_add	
/admin/autor/questaogrupo/<var>/history/	django.contrib.admin.options.history_view	admin:autor_questaogrupo_history	
/admin/autor/questaogrupo/<var>/delete/	django.contrib.admin.options.delete_view	admin:autor_questaogrupo_delete	
/admin/autor/questaogrupo/<var>/	django.contrib.admin.options.change_view	admin:autor_questaogrupo_change	
/admin/autor/gruposimulado/	apps.autor.admin.changelist_view	admin:autor_gruposimulado_changelist	
/admin/autor/gruposimulado/add/	django.contrib.admin.options.add_view	admin:autor_gruposimulado_add	
/admin/autor/gruposimulado/<var>/history/	django.contrib.admin.options.history_view	admin:autor_gruposimulado_history	
/admin/autor/gruposimulado/<var>/delete/	django.contrib.admin.options.delete_view	admin:autor_gruposimulado_delete	
/admin/autor/gruposimulado/<var>/	django.contrib.admin.options.change_view	admin:autor_gruposimulado_change	
/admin/autor/questaoc/	django.contrib.admin.options.changelist_view	admin:autor_questaoc_changelist	
/admin/autor/questaoc/add/	django.contrib.admin.options.add_view	admin:autor_questaoc_add	
/admin/autor/questaoc/<var>/history/	django.contrib.admin.options.history_view	admin:autor_questaoc_history	
/admin/autor/questaoc/<var>/delete/	django.contrib.admin.options.delete_view	admin:autor_questaoc_delete	
/admin/autor/questaoc/<var>/	django.contrib.admin.options.change_view	admin:autor_questaoc_change	
/admin/autor/disciplinagrupo/	django.contrib.admin.options.changelist_view	admin:autor_disciplinagrupo_changelist	
/admin/autor/disciplinagrupo/add/	django.contrib.admin.options.add_view	admin:autor_disciplinagrupo_add	
/admin/autor/disciplinagrupo/<var>/history/	django.contrib.admin.options.history_view	admin:autor_disciplinagrupo_history	
/admin/autor/disciplinagrupo/<var>/delete/	django.contrib.admin.options.delete_view	admin:autor_disciplinagrupo_delete	
/admin/autor/disciplinagrupo/<var>/	django.contrib.admin.options.change_view	admin:autor_disciplinagrupo_change	
/admin/enunciado/esferageral/	django.contrib.admin.options.changelist_view	admin:enunciado_esferageral_changelist	
/admin/enunciado/esferageral/add/	django.contrib.admin.options.add_view	admin:enunciado_esferageral_add	
/admin/enunciado/esferageral/<var>/history/	django.contrib.admin.options.history_view	admin:enunciado_esferageral_history	
/admin/enunciado/esferageral/<var>/delete/	django.contrib.admin.options.delete_view	admin:enunciado_esferageral_delete	
/admin/enunciado/esferageral/<var>/	django.contrib.admin.options.change_view	admin:enunciado_esferageral_change	
/admin/pagseguro/transaction/	django.contrib.admin.options.changelist_view	admin:pagseguro_transaction_changelist	
/admin/pagseguro/transaction/add/	django.contrib.admin.options.add_view	admin:pagseguro_transaction_add	
/admin/pagseguro/transaction/<var>/history/	django.contrib.admin.options.history_view	admin:pagseguro_transaction_history	
/admin/pagseguro/transaction/<var>/delete/	django.contrib.admin.options.delete_view	admin:pagseguro_transaction_delete	
/admin/pagseguro/transaction/<var>/	django.contrib.admin.options.change_view	admin:pagseguro_transaction_change	
/admin/curso/autor/	django.contrib.admin.options.changelist_view	admin:curso_autor_changelist	
/admin/curso/autor/add/	django.contrib.admin.options.add_view	admin:curso_autor_add	
/admin/curso/autor/<var>/history/	django.contrib.admin.options.history_view	admin:curso_autor_history	
/admin/curso/autor/<var>/delete/	django.contrib.admin.options.delete_view	admin:curso_autor_delete	
/admin/curso/autor/<var>/	django.contrib.admin.options.change_view	admin:curso_autor_change	
/admin/enunciado/roteiroestudo/	django.contrib.admin.options.changelist_view	admin:enunciado_roteiroestudo_changelist	
/admin/enunciado/roteiroestudo/add/	django.contrib.admin.options.add_view	admin:enunciado_roteiroestudo_add	
/admin/enunciado/roteiroestudo/<var>/history/	django.contrib.admin.options.history_view	admin:enunciado_roteiroestudo_history	
/admin/enunciado/roteiroestudo/<var>/delete/	django.contrib.admin.options.delete_view	admin:enunciado_roteiroestudo_delete	
/admin/enunciado/roteiroestudo/<var>/	django.contrib.admin.options.change_view	admin:enunciado_roteiroestudo_change	
/admin/enunciado/organizador/	django.contrib.admin.options.changelist_view	admin:enunciado_organizador_changelist	
/admin/enunciado/organizador/add/	django.contrib.admin.options.add_view	admin:enunciado_organizador_add	
/admin/enunciado/organizador/<var>/history/	django.contrib.admin.options.history_view	admin:enunciado_organizador_history	
/admin/enunciado/organizador/<var>/delete/	django.contrib.admin.options.delete_view	admin:enunciado_organizador_delete	
/admin/enunciado/organizador/<var>/	django.contrib.admin.options.change_view	admin:enunciado_organizador_change	
/admin/formulario_correcao/nota/	django.contrib.admin.options.changelist_view	admin:formulario_correcao_nota_changelist	
/admin/formulario_correcao/nota/add/	django.contrib.admin.options.add_view	admin:formulario_correcao_nota_add	
/admin/formulario_correcao/nota/<var>/history/	django.contrib.admin.options.history_view	admin:formulario_correcao_nota_history	
/admin/formulario_correcao/nota/<var>/delete/	django.contrib.admin.options.delete_view	admin:formulario_correcao_nota_delete	
/admin/formulario_correcao/nota/<var>/	django.contrib.admin.options.change_view	admin:formulario_correcao_nota_change	
/admin/curso/destaque/	django.contrib.admin.options.changelist_view	admin:curso_destaque_changelist	
/admin/curso/destaque/add/	django.contrib.admin.options.add_view	admin:curso_destaque_add	
/admin/curso/destaque/<var>/history/	django.contrib.admin.options.history_view	admin:curso_destaque_history	
/admin/curso/destaque/<var>/delete/	django.contrib.admin.options.delete_view	admin:curso_destaque_delete	
/admin/curso/destaque/<var>/	django.contrib.admin.options.change_view	admin:curso_destaque_change	
/admin/enunciado/cargo/	django.contrib.admin.options.changelist_view	admin:enunciado_cargo_changelist	
/admin/enunciado/cargo/add/	django.contrib.admin.options.add_view	admin:enunciado_cargo_add	
/admin/enunciado/cargo/<var>/history/	django.contrib.admin.options.history_view	admin:enunciado_cargo_history	
/admin/enunciado/cargo/<var>/delete/	django.contrib.admin.options.delete_view	admin:enunciado_cargo_delete	
/admin/enunciado/cargo/<var>/	django.contrib.admin.options.change_view	admin:enunciado_cargo_change	
/admin/curso/videomodulo/	django.contrib.admin.options.changelist_view	admin:curso_videomodulo_changelist	
/admin/curso/videomodulo/add/	django.contrib.admin.options.add_view	admin:curso_videomodulo_add	
/admin/curso/videomodulo/<var>/history/	django.contrib.admin.options.history_view	admin:curso_videomodulo_history	
/admin/curso/videomodulo/<var>/delete/	django.contrib.admin.options.delete_view	admin:curso_videomodulo_delete	
/admin/curso/videomodulo/<var>/	django.contrib.admin.options.change_view	admin:curso_videomodulo_change	
/admin/curso/simulado/	django.contrib.admin.options.changelist_view	admin:curso_simulado_changelist	
/admin/curso/simulado/add/	django.contrib.admin.options.add_view	admin:curso_simulado_add	
/admin/curso/simulado/<var>/history/	django.contrib.admin.options.history_view	admin:curso_simulado_history	
/admin/curso/simulado/<var>/delete/	django.contrib.admin.options.delete_view	admin:curso_simulado_delete	
/admin/curso/simulado/<var>/	django.contrib.admin.options.change_view	admin:curso_simulado_change	
/admin/website/artigoindice/	django.contrib.admin.options.changelist_view	admin:website_artigoindice_changelist	
/admin/website/artigoindice/add/	django.contrib.admin.options.add_view	admin:website_artigoindice_add	
/admin/website/artigoindice/<var>/history/	django.contrib.admin.options.history_view	admin:website_artigoindice_history	
/admin/website/artigoindice/<var>/delete/	django.contrib.admin.options.delete_view	admin:website_artigoindice_delete	
/admin/website/artigoindice/<var>/	django.contrib.admin.options.change_view	admin:website_artigoindice_change	
/admin/quizz/respostaaluno/	django.contrib.admin.options.changelist_view	admin:quizz_respostaaluno_changelist	
/admin/quizz/respostaaluno/add/	django.contrib.admin.options.add_view	admin:quizz_respostaaluno_add	
/admin/quizz/respostaaluno/<var>/history/	django.contrib.admin.options.history_view	admin:quizz_respostaaluno_history	
/admin/quizz/respostaaluno/<var>/delete/	django.contrib.admin.options.delete_view	admin:quizz_respostaaluno_delete	
/admin/quizz/respostaaluno/<var>/	django.contrib.admin.options.change_view	admin:quizz_respostaaluno_change	
/admin/autor/assuntogeral/	django.contrib.admin.options.changelist_view	admin:autor_assuntogeral_changelist	
/admin/autor/assuntogeral/add/	django.contrib.admin.options.add_view	admin:autor_assuntogeral_add	
/admin/autor/assuntogeral/<var>/history/	django.contrib.admin.options.history_view	admin:autor_assuntogeral_history	
/admin/autor/assuntogeral/<var>/delete/	django.contrib.admin.options.delete_view	admin:autor_assuntogeral_delete	
/admin/autor/assuntogeral/<var>/	apps.autor.admin.change_view	admin:autor_assuntogeral_change	
/admin/enunciado/roteiroestudoitem/	django.contrib.admin.options.changelist_view	admin:enunciado_roteiroestudoitem_changelist	
/admin/enunciado/roteiroestudoitem/add/	django.contrib.admin.options.add_view	admin:enunciado_roteiroestudoitem_add	
/admin/enunciado/roteiroestudoitem/<var>/history/	django.contrib.admin.options.history_view	admin:enunciado_roteiroestudoitem_history	
/admin/enunciado/roteiroestudoitem/<var>/delete/	django.contrib.admin.options.delete_view	admin:enunciado_roteiroestudoitem_delete	
/admin/enunciado/roteiroestudoitem/<var>/	django.contrib.admin.options.change_view	admin:enunciado_roteiroestudoitem_change	
/admin/website/videojustutor/	django.contrib.admin.options.changelist_view	admin:website_videojustutor_changelist	
/admin/website/videojustutor/add/	django.contrib.admin.options.add_view	admin:website_videojustutor_add	
/admin/website/videojustutor/<var>/history/	django.contrib.admin.options.history_view	admin:website_videojustutor_history	
/admin/website/videojustutor/<var>/delete/	django.contrib.admin.options.delete_view	admin:website_videojustutor_delete	
/admin/website/videojustutor/<var>/	django.contrib.admin.options.change_view	admin:website_videojustutor_change	
/admin/filer/file/	django.contrib.admin.options.changelist_view	admin:filer_file_changelist	
/admin/filer/file/add/	django.contrib.admin.options.add_view	admin:filer_file_add	
/admin/filer/file/<var>/history/	django.contrib.admin.options.history_view	admin:filer_file_history	
/admin/filer/file/<var>/delete/	filer.admin.fileadmin.delete_view	admin:filer_file_delete	
/admin/filer/file/<var>/	django.contrib.admin.options.change_view	admin:filer_file_change	
/admin/enunciado/tipoprocedimento/	django.contrib.admin.options.changelist_view	admin:enunciado_tipoprocedimento_changelist	
/admin/enunciado/tipoprocedimento/add/	django.contrib.admin.options.add_view	admin:enunciado_tipoprocedimento_add	
/admin/enunciado/tipoprocedimento/<var>/history/	django.contrib.admin.options.history_view	admin:enunciado_tipoprocedimento_history	
/admin/enunciado/tipoprocedimento/<var>/delete/	django.contrib.admin.options.delete_view	admin:enunciado_tipoprocedimento_delete	
/admin/enunciado/tipoprocedimento/<var>/	django.contrib.admin.options.change_view	admin:enunciado_tipoprocedimento_change	
/admin/formulario_auto_correcao/tabela/	django.contrib.admin.options.changelist_view	admin:formulario_auto_correcao_tabela_changelist	
/admin/formulario_auto_correcao/tabela/add/	django.contrib.admin.options.add_view	admin:formulario_auto_correcao_tabela_add	
/admin/formulario_auto_correcao/tabela/<var>/history/	django.contrib.admin.options.history_view	admin:formulario_auto_correcao_tabela_history	
/admin/formulario_auto_correcao/tabela/<var>/delete/	django.contrib.admin.options.delete_view	admin:formulario_auto_correcao_tabela_delete	
/admin/formulario_auto_correcao/tabela/<var>/	django.contrib.admin.options.change_view	admin:formulario_auto_correcao_tabela_change	
/admin/website/banner/	django.contrib.admin.options.changelist_view	admin:website_banner_changelist	
/admin/website/banner/add/	django.contrib.admin.options.add_view	admin:website_banner_add	
/admin/website/banner/<var>/history/	django.contrib.admin.options.history_view	admin:website_banner_history	
/admin/website/banner/<var>/delete/	django.contrib.admin.options.delete_view	admin:website_banner_delete	
/admin/website/banner/<var>/	django.contrib.admin.options.change_view	admin:website_banner_change	
/admin/website/artigo/	django.contrib.admin.options.changelist_view	admin:website_artigo_changelist	
/admin/website/artigo/add/	django.contrib.admin.options.add_view	admin:website_artigo_add	
/admin/website/artigo/<var>/history/	django.contrib.admin.options.history_view	admin:website_artigo_history	
/admin/website/artigo/<var>/delete/	django.contrib.admin.options.delete_view	admin:website_artigo_delete	
/admin/website/artigo/<var>/	django.contrib.admin.options.change_view	admin:website_artigo_change	
/admin/formulario_auto_correcao/nota/	django.contrib.admin.options.changelist_view	admin:formulario_auto_correcao_nota_changelist	
/admin/formulario_auto_correcao/nota/add/	django.contrib.admin.options.add_view	admin:formulario_auto_correcao_nota_add	
/admin/formulario_auto_correcao/nota/<var>/history/	django.contrib.admin.options.history_view	admin:formulario_auto_correcao_nota_history	
/admin/formulario_auto_correcao/nota/<var>/delete/	django.contrib.admin.options.delete_view	admin:formulario_auto_correcao_nota_delete	
/admin/formulario_auto_correcao/nota/<var>/	django.contrib.admin.options.change_view	admin:formulario_auto_correcao_nota_change	
/admin/formulario_auto_correcao/respostaaluno/	django.contrib.admin.options.changelist_view	admin:formulario_auto_correcao_respostaaluno_changelist	
/admin/formulario_auto_correcao/respostaaluno/add/	django.contrib.admin.options.add_view	admin:formulario_auto_correcao_respostaaluno_add	
/admin/formulario_auto_correcao/respostaaluno/<var>/history/	django.contrib.admin.options.history_view	admin:formulario_auto_correcao_respostaaluno_history	
/admin/formulario_auto_correcao/respostaaluno/<var>/delete/	django.contrib.admin.options.delete_view	admin:formulario_auto_correcao_respostaaluno_delete	
/admin/formulario_auto_correcao/respostaaluno/<var>/	django.contrib.admin.options.change_view	admin:formulario_auto_correcao_respostaaluno_change	
/admin/curso/sentencaoab/	django.contrib.admin.options.changelist_view	admin:curso_sentencaoab_changelist	
/admin/curso/sentencaoab/add/	django.contrib.admin.options.add_view	admin:curso_sentencaoab_add	
/admin/curso/sentencaoab/<var>/history/	django.contrib.admin.options.history_view	admin:curso_sentencaoab_history	
/admin/curso/sentencaoab/<var>/delete/	django.contrib.admin.options.delete_view	admin:curso_sentencaoab_delete	
/admin/curso/sentencaoab/<var>/	django.contrib.admin.options.change_view	admin:curso_sentencaoab_change	
/admin/autor/respostaquestionarioaluno/	django.contrib.admin.options.changelist_view	admin:autor_respostaquestionarioaluno_changelist	
/admin/autor/respostaquestionarioaluno/add/	django.contrib.admin.options.add_view	admin:autor_respostaquestionarioaluno_add	
/admin/autor/respostaquestionarioaluno/<var>/history/	django.contrib.admin.options.history_view	admin:autor_respostaquestionarioaluno_history	
/admin/autor/respostaquestionarioaluno/<var>/delete/	django.contrib.admin.options.delete_view	admin:autor_respostaquestionarioaluno_delete	
/admin/autor/respostaquestionarioaluno/<var>/	django.contrib.admin.options.change_view	admin:autor_respostaquestionarioaluno_change	
/admin/autor/questionarioaluno/	django.contrib.admin.options.changelist_view	admin:autor_questionarioaluno_changelist	
/admin/autor/questionarioaluno/add/	django.contrib.admin.options.add_view	admin:autor_questionarioaluno_add	
/admin/autor/questionarioaluno/<var>/history/	django.contrib.admin.options.history_view	admin:autor_questionarioaluno_history	
/admin/autor/questionarioaluno/<var>/delete/	django.contrib.admin.options.delete_view	admin:autor_questionarioaluno_delete	
/admin/autor/questionarioaluno/<var>/	django.contrib.admin.options.change_view	admin:autor_questionarioaluno_change	
/admin/enunciado/tipopecasentenca/	django.contrib.admin.options.changelist_view	admin:enunciado_tipopecasentenca_changelist	
/admin/enunciado/tipopecasentenca/add/	django.contrib.admin.options.add_view	admin:enunciado_tipopecasentenca_add	
/admin/enunciado/tipopecasentenca/<var>/history/	django.contrib.admin.options.history_view	admin:enunciado_tipopecasentenca_history	
/admin/enunciado/tipopecasentenca/<var>/delete/	django.contrib.admin.options.delete_view	admin:enunciado_tipopecasentenca_delete	
/admin/enunciado/tipopecasentenca/<var>/	django.contrib.admin.options.change_view	admin:enunciado_tipopecasentenca_change	
/admin/website/anuncio/	django.contrib.admin.options.changelist_view	admin:website_anuncio_changelist	
/admin/website/anuncio/add/	django.contrib.admin.options.add_view	admin:website_anuncio_add	
/admin/website/anuncio/<var>/history/	django.contrib.admin.options.history_view	admin:website_anuncio_history	
/admin/website/anuncio/<var>/delete/	django.contrib.admin.options.delete_view	admin:website_anuncio_delete	
/admin/website/anuncio/<var>/	django.contrib.admin.options.change_view	admin:website_anuncio_change	
/admin/formulario_correcao/formulario/	django.contrib.admin.options.changelist_view	admin:formulario_correcao_formulario_changelist	
/admin/formulario_correcao/formulario/add/	django.contrib.admin.options.add_view	admin:formulario_correcao_formulario_add	
/admin/formulario_correcao/formulario/<var>/history/	django.contrib.admin.options.history_view	admin:formulario_correcao_formulario_history	
/admin/formulario_correcao/formulario/<var>/delete/	django.contrib.admin.options.delete_view	admin:formulario_correcao_formulario_delete	
/admin/formulario_correcao/formulario/<var>/	django.contrib.admin.options.change_view	admin:formulario_correcao_formulario_change	
/admin/curso/checkoutitens/	django.contrib.admin.options.changelist_view	admin:curso_checkoutitens_changelist	
/admin/curso/checkoutitens/add/	django.contrib.admin.options.add_view	admin:curso_checkoutitens_add	
/admin/curso/checkoutitens/<var>/history/	django.contrib.admin.options.history_view	admin:curso_checkoutitens_history	
/admin/curso/checkoutitens/<var>/delete/	django.contrib.admin.options.delete_view	admin:curso_checkoutitens_delete	
/admin/curso/checkoutitens/<var>/	django.contrib.admin.options.change_view	admin:curso_checkoutitens_change	
/admin/curso/modulo/	django.contrib.admin.options.changelist_view	admin:curso_modulo_changelist	
/admin/curso/modulo/add/	django.contrib.admin.options.add_view	admin:curso_modulo_add	
/admin/curso/modulo/<var>/history/	django.contrib.admin.options.history_view	admin:curso_modulo_history	
/admin/curso/modulo/<var>/delete/	django.contrib.admin.options.delete_view	admin:curso_modulo_delete	
/admin/curso/modulo/<var>/	django.contrib.admin.options.change_view	admin:curso_modulo_change	
/admin/enunciado/rankingpremiado/	django.contrib.admin.options.changelist_view	admin:enunciado_rankingpremiado_changelist	
/admin/enunciado/rankingpremiado/add/	django.contrib.admin.options.add_view	admin:enunciado_rankingpremiado_add	
/admin/enunciado/rankingpremiado/<var>/history/	django.contrib.admin.options.history_view	admin:enunciado_rankingpremiado_history	
/admin/enunciado/rankingpremiado/<var>/delete/	django.contrib.admin.options.delete_view	admin:enunciado_rankingpremiado_delete	
/admin/enunciado/rankingpremiado/<var>/	django.contrib.admin.options.change_view	admin:enunciado_rankingpremiado_change	
/admin/autor/questaom/	django.contrib.admin.options.changelist_view	admin:autor_questaom_changelist	
/admin/autor/questaom/add/	django.contrib.admin.options.add_view	admin:autor_questaom_add	
/admin/autor/questaom/<var>/history/	django.contrib.admin.options.history_view	admin:autor_questaom_history	
/admin/autor/questaom/<var>/delete/	django.contrib.admin.options.delete_view	admin:autor_questaom_delete	
/admin/autor/questaom/<var>/	django.contrib.admin.options.change_view	admin:autor_questaom_change	
/admin/professor/professor/	django.contrib.admin.options.changelist_view	admin:professor_professor_changelist	
/admin/professor/professor/add/	django.contrib.admin.options.add_view	admin:professor_professor_add	
/admin/professor/professor/<var>/history/	django.contrib.admin.options.history_view	admin:professor_professor_history	
/admin/professor/professor/<var>/delete/	django.contrib.admin.options.delete_view	admin:professor_professor_delete	
/admin/professor/professor/<var>/	django.contrib.admin.options.change_view	admin:professor_professor_change	
/admin/curso/serie/	django.contrib.admin.options.changelist_view	admin:curso_serie_changelist	
/admin/curso/serie/add/	django.contrib.admin.options.add_view	admin:curso_serie_add	
/admin/curso/serie/<var>/history/	django.contrib.admin.options.history_view	admin:curso_serie_history	
/admin/curso/serie/<var>/delete/	django.contrib.admin.options.delete_view	admin:curso_serie_delete	
/admin/curso/serie/<var>/	django.contrib.admin.options.change_view	admin:curso_serie_change	
/admin/autor/resultadoresposta/	django.contrib.admin.options.changelist_view	admin:autor_resultadoresposta_changelist	
/admin/autor/resultadoresposta/add/	django.contrib.admin.options.add_view	admin:autor_resultadoresposta_add	
/admin/autor/resultadoresposta/<var>/history/	django.contrib.admin.options.history_view	admin:autor_resultadoresposta_history	
/admin/autor/resultadoresposta/<var>/delete/	django.contrib.admin.options.delete_view	admin:autor_resultadoresposta_delete	
/admin/autor/resultadoresposta/<var>/	django.contrib.admin.options.change_view	admin:autor_resultadoresposta_change	
/admin/enunciado/roteiroestudosubitem/	django.contrib.admin.options.changelist_view	admin:enunciado_roteiroestudosubitem_changelist	
/admin/enunciado/roteiroestudosubitem/add/	django.contrib.admin.options.add_view	admin:enunciado_roteiroestudosubitem_add	
/admin/enunciado/roteiroestudosubitem/<var>/history/	django.contrib.admin.options.history_view	admin:enunciado_roteiroestudosubitem_history	
/admin/enunciado/roteiroestudosubitem/<var>/delete/	django.contrib.admin.options.delete_view	admin:enunciado_roteiroestudosubitem_delete	
/admin/enunciado/roteiroestudosubitem/<var>/	django.contrib.admin.options.change_view	admin:enunciado_roteiroestudosubitem_change	
/admin/aluno/aluno/<pk>/livros/	apps.aluno.admin.livros	admin:admin-cursos-aluno	
/admin/aluno/aluno/	django.contrib.admin.options.changelist_view	admin:aluno_aluno_changelist	
/admin/aluno/aluno/add/	django.contrib.admin.options.add_view	admin:aluno_aluno_add	
/admin/aluno/aluno/<var>/history/	django.contrib.admin.options.history_view	admin:aluno_aluno_history	
/admin/aluno/aluno/<var>/delete/	django.contrib.admin.options.delete_view	admin:aluno_aluno_delete	
/admin/aluno/aluno/<var>/	django.contrib.admin.options.change_view	admin:aluno_aluno_change	
/admin/autor/resultado/	django.contrib.admin.options.changelist_view	admin:autor_resultado_changelist	
/admin/autor/resultado/add/	django.contrib.admin.options.add_view	admin:autor_resultado_add	
/admin/autor/resultado/<var>/history/	django.contrib.admin.options.history_view	admin:autor_resultado_history	
/admin/autor/resultado/<var>/delete/	django.contrib.admin.options.delete_view	admin:autor_resultado_delete	
/admin/autor/resultado/<var>/	django.contrib.admin.options.change_view	admin:autor_resultado_change	
/admin/website/institucional/	django.contrib.admin.options.changelist_view	admin:website_institucional_changelist	
/admin/website/institucional/add/	django.contrib.admin.options.add_view	admin:website_institucional_add	
/admin/website/institucional/<var>/history/	django.contrib.admin.options.history_view	admin:website_institucional_history	
/admin/website/institucional/<var>/delete/	django.contrib.admin.options.delete_view	admin:website_institucional_delete	
/admin/website/institucional/<var>/	django.contrib.admin.options.change_view	admin:website_institucional_change	
/admin/curso/combo/	django.contrib.admin.options.changelist_view	admin:curso_combo_changelist	
/admin/curso/combo/add/	django.contrib.admin.options.add_view	admin:curso_combo_add	
/admin/curso/combo/<var>/history/	django.contrib.admin.options.history_view	admin:curso_combo_history	
/admin/curso/combo/<var>/delete/	django.contrib.admin.options.delete_view	admin:curso_combo_delete	
/admin/curso/combo/<var>/	django.contrib.admin.options.change_view	admin:curso_combo_change	
/admin/enunciado/concurso/	django.contrib.admin.options.changelist_view	admin:enunciado_concurso_changelist	
/admin/enunciado/concurso/add/	django.contrib.admin.options.add_view	admin:enunciado_concurso_add	
/admin/enunciado/concurso/<var>/history/	django.contrib.admin.options.history_view	admin:enunciado_concurso_history	
/admin/enunciado/concurso/<var>/delete/	django.contrib.admin.options.delete_view	admin:enunciado_concurso_delete	
/admin/enunciado/concurso/<var>/	django.contrib.admin.options.change_view	admin:enunciado_concurso_change	
/admin/curso/curso/	django.contrib.admin.options.changelist_view	admin:curso_curso_changelist	
/admin/curso/curso/add/	django.contrib.admin.options.add_view	admin:curso_curso_add	
/admin/curso/curso/<var>/history/	django.contrib.admin.options.history_view	admin:curso_curso_history	
/admin/curso/curso/<var>/delete/	django.contrib.admin.options.delete_view	admin:curso_curso_delete	
/admin/curso/curso/<var>/	django.contrib.admin.options.change_view	admin:curso_curso_change	
/admin/corretor/corretor/	django.contrib.admin.options.changelist_view	admin:corretor_corretor_changelist	
/admin/corretor/corretor/add/	django.contrib.admin.options.add_view	admin:corretor_corretor_add	
/admin/corretor/corretor/<var>/history/	django.contrib.admin.options.history_view	admin:corretor_corretor_history	
/admin/corretor/corretor/<var>/delete/	django.contrib.admin.options.delete_view	admin:corretor_corretor_delete	
/admin/corretor/corretor/<var>/	django.contrib.admin.options.change_view	admin:corretor_corretor_change	
/admin/autor/questaoescolha/	django.contrib.admin.options.changelist_view	admin:autor_questaoescolha_changelist	
/admin/autor/questaoescolha/add/	django.contrib.admin.options.add_view	admin:autor_questaoescolha_add	
/admin/autor/questaoescolha/<var>/history/	django.contrib.admin.options.history_view	admin:autor_questaoescolha_history	
/admin/autor/questaoescolha/<var>/delete/	django.contrib.admin.options.delete_view	admin:autor_questaoescolha_delete	
/admin/autor/questaoescolha/<var>/	django.contrib.admin.options.change_view	admin:autor_questaoescolha_change	
/admin/curso/certificado/	django.contrib.admin.options.changelist_view	admin:curso_certificado_changelist	
/admin/curso/certificado/add/	django.contrib.admin.options.add_view	admin:curso_certificado_add	
/admin/curso/certificado/<var>/history/	django.contrib.admin.options.history_view	admin:curso_certificado_history	
/admin/curso/certificado/<var>/delete/	django.contrib.admin.options.delete_view	admin:curso_certificado_delete	
/admin/curso/certificado/<var>/	django.contrib.admin.options.change_view	admin:curso_certificado_change	
/admin/filer/folderpermission/	django.contrib.admin.options.changelist_view	admin:filer_folderpermission_changelist	
/admin/filer/folderpermission/add/	django.contrib.admin.options.add_view	admin:filer_folderpermission_add	
/admin/filer/folderpermission/<var>/history/	django.contrib.admin.options.history_view	admin:filer_folderpermission_history	
/admin/filer/folderpermission/<var>/delete/	django.contrib.admin.options.delete_view	admin:filer_folderpermission_delete	
/admin/filer/folderpermission/<var>/	django.contrib.admin.options.change_view	admin:filer_folderpermission_change	
/admin/enunciado/tipopecapratica/	django.contrib.admin.options.changelist_view	admin:enunciado_tipopecapratica_changelist	
/admin/enunciado/tipopecapratica/add/	django.contrib.admin.options.add_view	admin:enunciado_tipopecapratica_add	
/admin/enunciado/tipopecapratica/<var>/history/	django.contrib.admin.options.history_view	admin:enunciado_tipopecapratica_history	
/admin/enunciado/tipopecapratica/<var>/delete/	django.contrib.admin.options.delete_view	admin:enunciado_tipopecapratica_delete	
/admin/enunciado/tipopecapratica/<var>/	django.contrib.admin.options.change_view	admin:enunciado_tipopecapratica_change	
/admin/autor/autor/	django.contrib.admin.options.changelist_view	admin:autor_autor_changelist	
/admin/autor/autor/add/	django.contrib.admin.options.add_view	admin:autor_autor_add	
/admin/autor/autor/<var>/history/	django.contrib.admin.options.history_view	admin:autor_autor_history	
/admin/autor/autor/<var>/delete/	django.contrib.admin.options.delete_view	admin:autor_autor_delete	
/admin/autor/autor/<var>/	django.contrib.admin.options.change_view	admin:autor_autor_change	
/admin/curso/cursogratis/	django.contrib.admin.options.changelist_view	admin:curso_cursogratis_changelist	
/admin/curso/cursogratis/add/	django.contrib.admin.options.add_view	admin:curso_cursogratis_add	
/admin/curso/cursogratis/<var>/history/	django.contrib.admin.options.history_view	admin:curso_cursogratis_history	
/admin/curso/cursogratis/<var>/delete/	django.contrib.admin.options.delete_view	admin:curso_cursogratis_delete	
/admin/curso/cursogratis/<var>/	django.contrib.admin.options.change_view	admin:curso_cursogratis_change	
/admin/robots/url/	django.contrib.admin.options.changelist_view	admin:robots_url_changelist	
/admin/robots/url/add/	django.contrib.admin.options.add_view	admin:robots_url_add	
/admin/robots/url/<var>/history/	django.contrib.admin.options.history_view	admin:robots_url_history	
/admin/robots/url/<var>/delete/	django.contrib.admin.options.delete_view	admin:robots_url_delete	
/admin/robots/url/<var>/	django.contrib.admin.options.change_view	admin:robots_url_change	
/admin/sites/site/	django.contrib.admin.options.changelist_view	admin:sites_site_changelist	
/admin/sites/site/add/	django.contrib.admin.options.add_view	admin:sites_site_add	
/admin/sites/site/<var>/history/	django.contrib.admin.options.history_view	admin:sites_site_history	
/admin/sites/site/<var>/delete/	django.contrib.admin.options.delete_view	admin:sites_site_delete	
/admin/sites/site/<var>/	django.contrib.admin.options.change_view	admin:sites_site_change	
/admin/auth/user/<var>/password/	django.contrib.auth.admin.user_change_password	admin:auth_user_password_change	
/admin/auth/user/	django.contrib.admin.options.changelist_view	admin:auth_user_changelist	
/admin/auth/user/add/	django.contrib.auth.admin.add_view	admin:auth_user_add	
/admin/auth/user/<var>/history/	django.contrib.admin.options.history_view	admin:auth_user_history	
/admin/auth/user/<var>/delete/	django.contrib.admin.options.delete_view	admin:auth_user_delete	
/admin/auth/user/<var>/	django.contrib.admin.options.change_view	admin:auth_user_change	
/admin/website/noticia/	django.contrib.admin.options.changelist_view	admin:website_noticia_changelist	
/admin/website/noticia/add/	django.contrib.admin.options.add_view	admin:website_noticia_add	
/admin/website/noticia/<var>/history/	django.contrib.admin.options.history_view	admin:website_noticia_history	
/admin/website/noticia/<var>/delete/	django.contrib.admin.options.delete_view	admin:website_noticia_delete	
/admin/website/noticia/<var>/	django.contrib.admin.options.change_view	admin:website_noticia_change	
/admin/filer/folder/	filer.admin.folderadmin.directory_listing	admin:filer-directory_listing-root	
/admin/filer/folder/last/	filer.admin.folderadmin.directory_listing	admin:filer-directory_listing-last	
/admin/filer/folder/<folder_id>/list/	filer.admin.folderadmin.directory_listing	admin:filer-directory_listing	
/admin/filer/folder/<folder_id>/make_folder/	filer.admin.views.make_folder	admin:filer-directory_listing-make_folder	
/admin/filer/folder/make_folder/	filer.admin.views.make_folder	admin:filer-directory_listing-make_root_folder	
/admin/filer/folder/images_with_missing_data/	filer.admin.folderadmin.directory_listing	admin:filer-directory_listing-images_with_missing_data	
/admin/filer/folder/unfiled_images/	filer.admin.folderadmin.directory_listing	admin:filer-directory_listing-unfiled_images	
/admin/filer/folder/	django.contrib.admin.options.changelist_view	admin:filer_folder_changelist	
/admin/filer/folder/add/	django.contrib.admin.options.add_view	admin:filer_folder_add	
/admin/filer/folder/<var>/history/	django.contrib.admin.options.history_view	admin:filer_folder_history	
/admin/filer/folder/<var>/delete/	filer.admin.folderadmin.delete_view	admin:filer_folder_delete	
/admin/filer/folder/<var>/	django.contrib.admin.options.change_view	admin:filer_folder_change	
/admin/enunciado/orgaoentidade/	django.contrib.admin.options.changelist_view	admin:enunciado_orgaoentidade_changelist	
/admin/enunciado/orgaoentidade/add/	django.contrib.admin.options.add_view	admin:enunciado_orgaoentidade_add	
/admin/enunciado/orgaoentidade/<var>/history/	django.contrib.admin.options.history_view	admin:enunciado_orgaoentidade_history	
/admin/enunciado/orgaoentidade/<var>/delete/	django.contrib.admin.options.delete_view	admin:enunciado_orgaoentidade_delete	
/admin/enunciado/orgaoentidade/<var>/	django.contrib.admin.options.change_view	admin:enunciado_orgaoentidade_change	
/admin/curso/cursocredito/	django.contrib.admin.options.changelist_view	admin:curso_cursocredito_changelist	
/admin/curso/cursocredito/add/	django.contrib.admin.options.add_view	admin:curso_cursocredito_add	
/admin/curso/cursocredito/<var>/history/	django.contrib.admin.options.history_view	admin:curso_cursocredito_history	
/admin/curso/cursocredito/<var>/delete/	django.contrib.admin.options.delete_view	admin:curso_cursocredito_delete	
/admin/curso/cursocredito/<var>/	django.contrib.admin.options.change_view	admin:curso_cursocredito_change	
/admin/curso/categoria/	django.contrib.admin.options.changelist_view	admin:curso_categoria_changelist	
/admin/curso/categoria/add/	django.contrib.admin.options.add_view	admin:curso_categoria_add	
/admin/curso/categoria/<var>/history/	django.contrib.admin.options.history_view	admin:curso_categoria_history	
/admin/curso/categoria/<var>/delete/	django.contrib.admin.options.delete_view	admin:curso_categoria_delete	
/admin/curso/categoria/<var>/	django.contrib.admin.options.change_view	admin:curso_categoria_change	
/admin/robots/rule/	django.contrib.admin.options.changelist_view	admin:robots_rule_changelist	
/admin/robots/rule/add/	django.contrib.admin.options.add_view	admin:robots_rule_add	
/admin/robots/rule/<var>/history/	django.contrib.admin.options.history_view	admin:robots_rule_history	
/admin/robots/rule/<var>/delete/	django.contrib.admin.options.delete_view	admin:robots_rule_delete	
/admin/robots/rule/<var>/	django.contrib.admin.options.change_view	admin:robots_rule_change	
/admin/enunciado/tag/	django.contrib.admin.options.changelist_view	admin:enunciado_tag_changelist	
/admin/enunciado/tag/add/	django.contrib.admin.options.add_view	admin:enunciado_tag_add	
/admin/enunciado/tag/<var>/history/	django.contrib.admin.options.history_view	admin:enunciado_tag_history	
/admin/enunciado/tag/<var>/delete/	django.contrib.admin.options.delete_view	admin:enunciado_tag_delete	
/admin/enunciado/tag/<var>/	django.contrib.admin.options.change_view	admin:enunciado_tag_change	
/admin/threadedcomments/threadedcomment/	django.contrib.admin.options.changelist_view	admin:threadedcomments_threadedcomment_changelist	
/admin/threadedcomments/threadedcomment/add/	django.contrib.admin.options.add_view	admin:threadedcomments_threadedcomment_add	
/admin/threadedcomments/threadedcomment/<var>/history/	django.contrib.admin.options.history_view	admin:threadedcomments_threadedcomment_history	
/admin/threadedcomments/threadedcomment/<var>/delete/	django.contrib.admin.options.delete_view	admin:threadedcomments_threadedcomment_delete	
/admin/threadedcomments/threadedcomment/<var>/	django.contrib.admin.options.change_view	admin:threadedcomments_threadedcomment_change	
/admin/filer/clipboard/operations/paste_clipboard_to_folder/	filer.admin.views.paste_clipboard_to_folder	admin:filer-paste_clipboard_to_folder	
/admin/filer/clipboard/operations/discard_clipboard/	filer.admin.views.discard_clipboard	admin:filer-discard_clipboard	
/admin/filer/clipboard/operations/delete_clipboard/	filer.admin.views.delete_clipboard	admin:filer-delete_clipboard	
/admin/filer/clipboard/operations/upload/<folder_id>/	filer.admin.clipboardadmin.ajax_upload	admin:filer-ajax_upload	
/admin/filer/clipboard/operations/upload/no_folder/	filer.admin.clipboardadmin.ajax_upload	admin:filer-ajax_upload	
/admin/filer/clipboard/	django.contrib.admin.options.changelist_view	admin:filer_clipboard_changelist	
/admin/filer/clipboard/add/	django.contrib.admin.options.add_view	admin:filer_clipboard_add	
/admin/filer/clipboard/<var>/history/	django.contrib.admin.options.history_view	admin:filer_clipboard_history	
/admin/filer/clipboard/<var>/delete/	django.contrib.admin.options.delete_view	admin:filer_clipboard_delete	
/admin/filer/clipboard/<var>/	django.contrib.admin.options.change_view	admin:filer_clipboard_change	
/admin/financeiro/credito/	django.contrib.admin.options.changelist_view	admin:financeiro_credito_changelist	
/admin/financeiro/credito/add/	django.contrib.admin.options.add_view	admin:financeiro_credito_add	
/admin/financeiro/credito/<var>/history/	django.contrib.admin.options.history_view	admin:financeiro_credito_history	
/admin/financeiro/credito/<var>/delete/	django.contrib.admin.options.delete_view	admin:financeiro_credito_delete	
/admin/financeiro/credito/<var>/	django.contrib.admin.options.change_view	admin:financeiro_credito_change	
/admin/filer/image/	django.contrib.admin.options.changelist_view	admin:filer_image_changelist	
/admin/filer/image/add/	django.contrib.admin.options.add_view	admin:filer_image_add	
/admin/filer/image/<var>/history/	django.contrib.admin.options.history_view	admin:filer_image_history	
/admin/filer/image/<var>/delete/	filer.admin.fileadmin.delete_view	admin:filer_image_delete	
/admin/filer/image/<var>/	django.contrib.admin.options.change_view	admin:filer_image_change	
/admin/socialaccount/socialapp/	django.contrib.admin.options.changelist_view	admin:socialaccount_socialapp_changelist	
/admin/socialaccount/socialapp/add/	django.contrib.admin.options.add_view	admin:socialaccount_socialapp_add	
/admin/socialaccount/socialapp/<var>/history/	django.contrib.admin.options.history_view	admin:socialaccount_socialapp_history	
/admin/socialaccount/socialapp/<var>/delete/	django.contrib.admin.options.delete_view	admin:socialaccount_socialapp_delete	
/admin/socialaccount/socialapp/<var>/	django.contrib.admin.options.change_view	admin:socialaccount_socialapp_change	
/admin/autor/simulado/	django.contrib.admin.options.changelist_view	admin:autor_simulado_changelist	
/admin/autor/simulado/add/	django.contrib.admin.options.add_view	admin:autor_simulado_add	
/admin/autor/simulado/<var>/history/	django.contrib.admin.options.history_view	admin:autor_simulado_history	
/admin/autor/simulado/<var>/delete/	django.contrib.admin.options.delete_view	admin:autor_simulado_delete	
/admin/autor/simulado/<var>/	django.contrib.admin.options.change_view	admin:autor_simulado_change	
/admin/autor/assuntoespecifico/	django.contrib.admin.options.changelist_view	admin:autor_assuntoespecifico_changelist	
/admin/autor/assuntoespecifico/add/	django.contrib.admin.options.add_view	admin:autor_assuntoespecifico_add	
/admin/autor/assuntoespecifico/<var>/history/	django.contrib.admin.options.history_view	admin:autor_assuntoespecifico_history	
/admin/autor/assuntoespecifico/<var>/delete/	django.contrib.admin.options.delete_view	admin:autor_assuntoespecifico_delete	
/admin/autor/assuntoespecifico/<var>/	django.contrib.admin.options.change_view	admin:autor_assuntoespecifico_change	
/admin/enunciado/disciplina/	django.contrib.admin.options.changelist_view	admin:enunciado_disciplina_changelist	
/admin/enunciado/disciplina/add/	django.contrib.admin.options.add_view	admin:enunciado_disciplina_add	
/admin/enunciado/disciplina/<var>/history/	django.contrib.admin.options.history_view	admin:enunciado_disciplina_history	
/admin/enunciado/disciplina/<var>/delete/	django.contrib.admin.options.delete_view	admin:enunciado_disciplina_delete	
/admin/enunciado/disciplina/<var>/	django.contrib.admin.options.change_view	admin:enunciado_disciplina_change	
/admin/curso/sentencaoabavulsaaluno/	django.contrib.admin.options.changelist_view	admin:curso_sentencaoabavulsaaluno_changelist	
/admin/curso/sentencaoabavulsaaluno/add/	django.contrib.admin.options.add_view	admin:curso_sentencaoabavulsaaluno_add	
/admin/curso/sentencaoabavulsaaluno/<var>/history/	django.contrib.admin.options.history_view	admin:curso_sentencaoabavulsaaluno_history	
/admin/curso/sentencaoabavulsaaluno/<var>/delete/	django.contrib.admin.options.delete_view	admin:curso_sentencaoabavulsaaluno_delete	
/admin/curso/sentencaoabavulsaaluno/<var>/	django.contrib.admin.options.change_view	admin:curso_sentencaoabavulsaaluno_change	
/admin/curso/comboaluno/	django.contrib.admin.options.changelist_view	admin:curso_comboaluno_changelist	
/admin/curso/comboaluno/add/	django.contrib.admin.options.add_view	admin:curso_comboaluno_add	
/admin/curso/comboaluno/<var>/history/	django.contrib.admin.options.history_view	admin:curso_comboaluno_history	
/admin/curso/comboaluno/<var>/delete/	django.contrib.admin.options.delete_view	admin:curso_comboaluno_delete	
/admin/curso/comboaluno/<var>/	django.contrib.admin.options.change_view	admin:curso_comboaluno_change	
/admin/enunciado/enunciadoproposta/	django.contrib.admin.options.changelist_view	admin:enunciado_enunciadoproposta_changelist	
/admin/enunciado/enunciadoproposta/add/	django.contrib.admin.options.add_view	admin:enunciado_enunciadoproposta_add	
/admin/enunciado/enunciadoproposta/<var>/history/	django.contrib.admin.options.history_view	admin:enunciado_enunciadoproposta_history	
/admin/enunciado/enunciadoproposta/<var>/delete/	django.contrib.admin.options.delete_view	admin:enunciado_enunciadoproposta_delete	
/admin/enunciado/enunciadoproposta/<var>/	django.contrib.admin.options.change_view	admin:enunciado_enunciadoproposta_change	
/admin/financeiro/creditoresgate/	django.contrib.admin.options.changelist_view	admin:financeiro_creditoresgate_changelist	
/admin/financeiro/creditoresgate/add/	django.contrib.admin.options.add_view	admin:financeiro_creditoresgate_add	
/admin/financeiro/creditoresgate/<var>/history/	django.contrib.admin.options.history_view	admin:financeiro_creditoresgate_history	
/admin/financeiro/creditoresgate/<var>/delete/	django.contrib.admin.options.delete_view	admin:financeiro_creditoresgate_delete	
/admin/financeiro/creditoresgate/<var>/	django.contrib.admin.options.change_view	admin:financeiro_creditoresgate_change	
/admin/formulario_correcao/tabelaaluno/	django.contrib.admin.options.changelist_view	admin:formulario_correcao_tabelaaluno_changelist	
/admin/formulario_correcao/tabelaaluno/add/	django.contrib.admin.options.add_view	admin:formulario_correcao_tabelaaluno_add	
/admin/formulario_correcao/tabelaaluno/<var>/history/	django.contrib.admin.options.history_view	admin:formulario_correcao_tabelaaluno_history	
/admin/formulario_correcao/tabelaaluno/<var>/delete/	django.contrib.admin.options.delete_view	admin:formulario_correcao_tabelaaluno_delete	
/admin/formulario_correcao/tabelaaluno/<var>/	django.contrib.admin.options.change_view	admin:formulario_correcao_tabelaaluno_change	
/admin/enunciado/areaprofissional/	django.contrib.admin.options.changelist_view	admin:enunciado_areaprofissional_changelist	
/admin/enunciado/areaprofissional/add/	django.contrib.admin.options.add_view	admin:enunciado_areaprofissional_add	
/admin/enunciado/areaprofissional/<var>/history/	django.contrib.admin.options.history_view	admin:enunciado_areaprofissional_history	
/admin/enunciado/areaprofissional/<var>/delete/	django.contrib.admin.options.delete_view	admin:enunciado_areaprofissional_delete	
/admin/enunciado/areaprofissional/<var>/	django.contrib.admin.options.change_view	admin:enunciado_areaprofissional_change	
/admin/curso/tarefaatividade/	django.contrib.admin.options.changelist_view	admin:curso_tarefaatividade_changelist	
/admin/curso/tarefaatividade/add/	django.contrib.admin.options.add_view	admin:curso_tarefaatividade_add	
/admin/curso/tarefaatividade/<var>/history/	django.contrib.admin.options.history_view	admin:curso_tarefaatividade_history	
/admin/curso/tarefaatividade/<var>/delete/	django.contrib.admin.options.delete_view	admin:curso_tarefaatividade_delete	
/admin/curso/tarefaatividade/<var>/	django.contrib.admin.options.change_view	admin:curso_tarefaatividade_change	
/admin/quizz/comentario/	django.contrib.admin.options.changelist_view	admin:quizz_comentario_changelist	
/admin/quizz/comentario/add/	django.contrib.admin.options.add_view	admin:quizz_comentario_add	
/admin/quizz/comentario/<var>/history/	django.contrib.admin.options.history_view	admin:quizz_comentario_history	
/admin/quizz/comentario/<var>/delete/	django.contrib.admin.options.delete_view	admin:quizz_comentario_delete	
/admin/quizz/comentario/<var>/	django.contrib.admin.options.change_view	admin:quizz_comentario_change	
/admin/pagseguro/checkout/	django.contrib.admin.options.changelist_view	admin:pagseguro_checkout_changelist	
/admin/pagseguro/checkout/add/	django.contrib.admin.options.add_view	admin:pagseguro_checkout_add	
/admin/pagseguro/checkout/<var>/history/	django.contrib.admin.options.history_view	admin:pagseguro_checkout_history	
/admin/pagseguro/checkout/<var>/delete/	django.contrib.admin.options.delete_view	admin:pagseguro_checkout_delete	
/admin/pagseguro/checkout/<var>/	django.contrib.admin.options.change_view	admin:pagseguro_checkout_change	
/admin/socialaccount/socialtoken/	django.contrib.admin.options.changelist_view	admin:socialaccount_socialtoken_changelist	
/admin/socialaccount/socialtoken/add/	django.contrib.admin.options.add_view	admin:socialaccount_socialtoken_add	
/admin/socialaccount/socialtoken/<var>/history/	django.contrib.admin.options.history_view	admin:socialaccount_socialtoken_history	
/admin/socialaccount/socialtoken/<var>/delete/	django.contrib.admin.options.delete_view	admin:socialaccount_socialtoken_delete	
/admin/socialaccount/socialtoken/<var>/	django.contrib.admin.options.change_view	admin:socialaccount_socialtoken_change	
/admin/enunciado/enunciadopropostasentenca/<pk>/copiar_enunciado/	apps.enunciado.admin.copiar_enunciado		
/admin/enunciado/enunciadopropostasentenca/	django.contrib.admin.options.changelist_view	admin:enunciado_enunciadopropostasentenca_changelist	
/admin/enunciado/enunciadopropostasentenca/add/	django.contrib.admin.options.add_view	admin:enunciado_enunciadopropostasentenca_add	
/admin/enunciado/enunciadopropostasentenca/<var>/history/	django.contrib.admin.options.history_view	admin:enunciado_enunciadopropostasentenca_history	
/admin/enunciado/enunciadopropostasentenca/<var>/delete/	django.contrib.admin.options.delete_view	admin:enunciado_enunciadopropostasentenca_delete	
/admin/enunciado/enunciadopropostasentenca/<var>/	django.contrib.admin.options.change_view	admin:enunciado_enunciadopropostasentenca_change	
/admin/formulario_auto_correcao/formulario/	django.contrib.admin.options.changelist_view	admin:formulario_auto_correcao_formulario_changelist	
/admin/formulario_auto_correcao/formulario/add/	django.contrib.admin.options.add_view	admin:formulario_auto_correcao_formulario_add	
/admin/formulario_auto_correcao/formulario/<var>/history/	django.contrib.admin.options.history_view	admin:formulario_auto_correcao_formulario_history	
/admin/formulario_auto_correcao/formulario/<var>/delete/	django.contrib.admin.options.delete_view	admin:formulario_auto_correcao_formulario_delete	
/admin/formulario_auto_correcao/formulario/<var>/	django.contrib.admin.options.change_view	admin:formulario_auto_correcao_formulario_change	
/admin/website/configuracao/	django.contrib.admin.options.changelist_view	admin:website_configuracao_changelist	
/admin/website/configuracao/add/	django.contrib.admin.options.add_view	admin:website_configuracao_add	
/admin/website/configuracao/<var>/history/	django.contrib.admin.options.history_view	admin:website_configuracao_history	
/admin/website/configuracao/<var>/delete/	django.contrib.admin.options.delete_view	admin:website_configuracao_delete	
/admin/website/configuracao/<var>/	django.contrib.admin.options.change_view	admin:website_configuracao_change	
/admin/cupom/cupom/	django.contrib.admin.options.changelist_view	admin:cupom_cupom_changelist	
/admin/cupom/cupom/add/	django.contrib.admin.options.add_view	admin:cupom_cupom_add	
/admin/cupom/cupom/<var>/history/	django.contrib.admin.options.history_view	admin:cupom_cupom_history	
/admin/cupom/cupom/<var>/delete/	django.contrib.admin.options.delete_view	admin:cupom_cupom_delete	
/admin/cupom/cupom/<var>/	django.contrib.admin.options.change_view	admin:cupom_cupom_change	
/admin/formulario_auto_correcao/tabelacorrecaoaluno/	django.contrib.admin.options.changelist_view	admin:formulario_auto_correcao_tabelacorrecaoaluno_changelist	
/admin/formulario_auto_correcao/tabelacorrecaoaluno/add/	django.contrib.admin.options.add_view	admin:formulario_auto_correcao_tabelacorrecaoaluno_add	
/admin/formulario_auto_correcao/tabelacorrecaoaluno/<var>/history/	django.contrib.admin.options.history_view	admin:formulario_auto_correcao_tabelacorrecaoaluno_history	
/admin/formulario_auto_correcao/tabelacorrecaoaluno/<var>/delete/	django.contrib.admin.options.delete_view	admin:formulario_auto_correcao_tabelacorrecaoaluno_delete	
/admin/formulario_auto_correcao/tabelacorrecaoaluno/<var>/	django.contrib.admin.options.change_view	admin:formulario_auto_correcao_tabelacorrecaoaluno_change	
/admin/curso/colecao/	django.contrib.admin.options.changelist_view	admin:curso_colecao_changelist	
/admin/curso/colecao/add/	django.contrib.admin.options.add_view	admin:curso_colecao_add	
/admin/curso/colecao/<var>/history/	django.contrib.admin.options.history_view	admin:curso_colecao_history	
/admin/curso/colecao/<var>/delete/	django.contrib.admin.options.delete_view	admin:curso_colecao_delete	
/admin/curso/colecao/<var>/	django.contrib.admin.options.change_view	admin:curso_colecao_change	
/admin/formulario_correcao/tabelacorrecaoaluno/	django.contrib.admin.options.changelist_view	admin:formulario_correcao_tabelacorrecaoaluno_changelist	
/admin/formulario_correcao/tabelacorrecaoaluno/add/	django.contrib.admin.options.add_view	admin:formulario_correcao_tabelacorrecaoaluno_add	
/admin/formulario_correcao/tabelacorrecaoaluno/<var>/history/	django.contrib.admin.options.history_view	admin:formulario_correcao_tabelacorrecaoaluno_history	
/admin/formulario_correcao/tabelacorrecaoaluno/<var>/delete/	django.contrib.admin.options.delete_view	admin:formulario_correcao_tabelacorrecaoaluno_delete	
/admin/formulario_correcao/tabelacorrecaoaluno/<var>/	django.contrib.admin.options.change_view	admin:formulario_correcao_tabelacorrecaoaluno_change	
/admin/enunciado/enunciadopropostapratica/<pk>/copiar_enunciado/	apps.enunciado.admin.copiar_enunciado		
/admin/enunciado/enunciadopropostapratica/	django.contrib.admin.options.changelist_view	admin:enunciado_enunciadopropostapratica_changelist	
/admin/enunciado/enunciadopropostapratica/add/	django.contrib.admin.options.add_view	admin:enunciado_enunciadopropostapratica_add	
/admin/enunciado/enunciadopropostapratica/<var>/history/	django.contrib.admin.options.history_view	admin:enunciado_enunciadopropostapratica_history	
/admin/enunciado/enunciadopropostapratica/<var>/delete/	django.contrib.admin.options.delete_view	admin:enunciado_enunciadopropostapratica_delete	
/admin/enunciado/enunciadopropostapratica/<var>/	django.contrib.admin.options.change_view	admin:enunciado_enunciadopropostapratica_change	
/admin/filer/thumbnailoption/	django.contrib.admin.options.changelist_view	admin:filer_thumbnailoption_changelist	
/admin/filer/thumbnailoption/add/	django.contrib.admin.options.add_view	admin:filer_thumbnailoption_add	
/admin/filer/thumbnailoption/<var>/history/	django.contrib.admin.options.history_view	admin:filer_thumbnailoption_history	
/admin/filer/thumbnailoption/<var>/delete/	django.contrib.admin.options.delete_view	admin:filer_thumbnailoption_delete	
/admin/filer/thumbnailoption/<var>/	django.contrib.admin.options.change_view	admin:filer_thumbnailoption_change	
/admin/professor/mensagem/	django.contrib.admin.options.changelist_view	admin:professor_mensagem_changelist	
/admin/professor/mensagem/add/	django.contrib.admin.options.add_view	admin:professor_mensagem_add	
/admin/professor/mensagem/<var>/history/	django.contrib.admin.options.history_view	admin:professor_mensagem_history	
/admin/professor/mensagem/<var>/delete/	django.contrib.admin.options.delete_view	admin:professor_mensagem_delete	
/admin/professor/mensagem/<var>/	django.contrib.admin.options.change_view	admin:professor_mensagem_change	
/admin/formulario_auto_correcao/tabelaaluno/	django.contrib.admin.options.changelist_view	admin:formulario_auto_correcao_tabelaaluno_changelist	
/admin/formulario_auto_correcao/tabelaaluno/add/	django.contrib.admin.options.add_view	admin:formulario_auto_correcao_tabelaaluno_add	
/admin/formulario_auto_correcao/tabelaaluno/<var>/history/	django.contrib.admin.options.history_view	admin:formulario_auto_correcao_tabelaaluno_history	
/admin/formulario_auto_correcao/tabelaaluno/<var>/delete/	django.contrib.admin.options.delete_view	admin:formulario_auto_correcao_tabelaaluno_delete	
/admin/formulario_auto_correcao/tabelaaluno/<var>/	django.contrib.admin.options.change_view	admin:formulario_auto_correcao_tabelaaluno_change	
/admin/financeiro/configuracaopacote/	django.contrib.admin.options.changelist_view	admin:financeiro_configuracaopacote_changelist	
/admin/financeiro/configuracaopacote/add/	django.contrib.admin.options.add_view	admin:financeiro_configuracaopacote_add	
/admin/financeiro/configuracaopacote/<var>/history/	django.contrib.admin.options.history_view	admin:financeiro_configuracaopacote_history	
/admin/financeiro/configuracaopacote/<var>/delete/	django.contrib.admin.options.delete_view	admin:financeiro_configuracaopacote_delete	
/admin/financeiro/configuracaopacote/<var>/	django.contrib.admin.options.change_view	admin:financeiro_configuracaopacote_change	
/admin/formulario_correcao/tabela/	django.contrib.admin.options.changelist_view	admin:formulario_correcao_tabela_changelist	
/admin/formulario_correcao/tabela/add/	django.contrib.admin.options.add_view	admin:formulario_correcao_tabela_add	
/admin/formulario_correcao/tabela/<var>/history/	django.contrib.admin.options.history_view	admin:formulario_correcao_tabela_history	
/admin/formulario_correcao/tabela/<var>/delete/	django.contrib.admin.options.delete_view	admin:formulario_correcao_tabela_delete	
/admin/formulario_correcao/tabela/<var>/	django.contrib.admin.options.change_view	admin:formulario_correcao_tabela_change	
/admin/autor/questao/	django.contrib.admin.options.changelist_view	admin:autor_questao_changelist	
/admin/autor/questao/add/	django.contrib.admin.options.add_view	admin:autor_questao_add	
/admin/autor/questao/<var>/history/	django.contrib.admin.options.history_view	admin:autor_questao_history	
/admin/autor/questao/<var>/delete/	django.contrib.admin.options.delete_view	admin:autor_questao_delete	
/admin/autor/questao/<var>/	django.contrib.admin.options.change_view	admin:autor_questao_change	
/admin/curso/liberarcompracurso/	django.contrib.admin.options.changelist_view	admin:curso_liberarcompracurso_changelist	
/admin/curso/liberarcompracurso/add/	django.contrib.admin.options.add_view	admin:curso_liberarcompracurso_add	
/admin/curso/liberarcompracurso/<var>/history/	django.contrib.admin.options.history_view	admin:curso_liberarcompracurso_history	
/admin/curso/liberarcompracurso/<var>/delete/	django.contrib.admin.options.delete_view	admin:curso_liberarcompracurso_delete	
/admin/curso/liberarcompracurso/<var>/	django.contrib.admin.options.change_view	admin:curso_liberarcompracurso_change	
/admin/enunciado/correcao/	django.contrib.admin.options.changelist_view	admin:enunciado_correcao_changelist	
/admin/enunciado/correcao/add/	django.contrib.admin.options.add_view	admin:enunciado_correcao_add	
/admin/enunciado/correcao/<var>/history/	django.contrib.admin.options.history_view	admin:enunciado_correcao_history	
/admin/enunciado/correcao/<var>/delete/	django.contrib.admin.options.delete_view	admin:enunciado_correcao_delete	
/admin/enunciado/correcao/<var>/	django.contrib.admin.options.change_view	admin:enunciado_correcao_change	
/admin/curso/livro/	django.contrib.admin.options.changelist_view	admin:curso_livro_changelist	
/admin/curso/livro/add/	django.contrib.admin.options.add_view	admin:curso_livro_add	
/admin/curso/livro/<var>/history/	django.contrib.admin.options.history_view	admin:curso_livro_history	
/admin/curso/livro/<var>/delete/	django.contrib.admin.options.delete_view	admin:curso_livro_delete	
/admin/curso/livro/<var>/	django.contrib.admin.options.change_view	admin:curso_livro_change	
/admin/<app_label>/	django.contrib.admin.sites.app_index	admin:app_list	
/admin/gerarcupons/	apps.cupom.views.gerarcupons		
/robots.txt	robots.views.RuleList	robots_rule_list	
/admin/filebrowser/browse/	filebrowser.views.browse	fb_browse	
/admin/filebrowser/mkdir/	filebrowser.views.mkdir	fb_mkdir	
/admin/filebrowser/upload/	filebrowser.views.upload	fb_upload	
/admin/filebrowser/rename/	filebrowser.views.rename	fb_rename	
/admin/filebrowser/delete/	filebrowser.views.delete	fb_delete	
/admin/filebrowser/versions/	filebrowser.views.versions	fb_versions	
/admin/filebrowser/check_file/	filebrowser.views._check_file	fb_check	
/admin/filebrowser/upload_file/	filebrowser.decorators.decorator	fb_do_upload	
/	apps.website.views.index	website:index	
/professores/	apps.website.views.ProfessorView	website:professores	
/institucional/<slug>/	apps.website.views.institucional	website:institucional	
/livraria/<slug>/	apps.website.views.livraria	website:livraria	
/livraria/livro/<slug>/	apps.website.views.livro	website:livro	
/noticia/<slug>/	apps.website.views.noticia	website:noticia	
/consulta-certificado/<chave>/	apps.website.views.consulta_certificado	website:consulta-certificado	
/php/handler.php	apps.website.views.subscrible	website:subscrible	
/imagens/	apps.website.views.imagens	website:imagens	
/noticias-justutor/	apps.website.views.noticias_justutor	website:noticias-justutor	
/artigo-indice	apps.website.views.artigo_indice	website:artigo-indice	
/artigo-imprimir/<aid>/	apps.website.views.artigo_imprimir	website:artigo-imprimir	
/busca/	apps.website.views.busca	website:busca	
/busca-aluno/	apps.website.views.busca_aluno	website:busca-aluno	
/busca-tag/	apps.website.views.busca_tag	website:busca-tag	
/check-login/	apps.website.views.check_login	website:check-login	
/ajax-login/	apps.website.views.ajax_login	website:ajax-login	
/ajax-cadastro/	apps.website.views.ajax_cadastro	website:ajax-cadastro	
/email/	apps.website.views.email	website:email	
/pagseg/checkout/	apps.website.views.pagseguro_checkout	website:pagseguro_checkout	
/pagseg/settransaction/	apps.website.views.pagseguro_set_transaction	website:pagseguro_settransaction	
/pagseg/transacao/<code>/	apps.website.views.pagseguro_transaction	website:pagseguro_transaction	
/pagseg/transacao/	apps.website.views.pagseguro_transaction	website:pagseguro_transaction_nocode	
/checkout/itens/	apps.website.views.checkout_itens	website:checkout_itens	
/checkout/pagamento/	apps.website.views.checkout_itens	website:checkout_pagamentos	
/v2/	apps.website.views.HomeView	website:home	
/aluno/painel/	apps.aluno.views.painel	aluno:painel	
/aluno/relatorio/	apps.aluno.views.relatorio	aluno:relatorio	
/aluno/lista/	apps.aluno.views.lista	aluno:lista	
/aluno/producao/	apps.aluno.views.perfil	aluno:perfil	
/aluno/cursos/	apps.aluno.views.cursos	aluno:cursos	
/aluno/simulados/	apps.aluno.views.simulados	aluno:simulados	
/aluno/simuladoinfo/<pk>/	apps.aluno.views.simuladoinfo	aluno:simuladoinfo	
/aluno/simulado/questionario/<pk>/	apps.autor.views.questionario	aluno:simulado:questionario	
/aluno/simulado/ajax-responder/	apps.autor.views.ajax_responder	aluno:simulado:ajax-responder	
/aluno/simulado/ajax-questao-render/	apps.autor.views.ajax_questao_render	aluno:simulado:ajax-questao-render	
/aluno/simulado/ajax-update-timer/	apps.autor.views.ajax_update_timer	aluno:simulado:ajax-update-timer	
/aluno/simulado/ajax-check-time/	apps.autor.views.ajax_check_time	aluno:simulado:ajax-check-time	
/aluno/simulado/ajax-check-time/	apps.autor.views.ajax_check_time	aluno:simulado:ajax-check-time	
/aluno/simulado/ajax-encerrar-simulado/	apps.autor.views.ajax_encerrar_simulado	aluno:simulado:ajax-encerrar-simulado	
/aluno/simulado/ajax-render-comentario/	apps.autor.views.ajax_render_comentario	aluno:simulado:ajax-render-comentario	
/aluno/simulado/ajax-render-html/	apps.autor.views.ajax_render_html	aluno:simulado:ajax-render-html	
/aluno/simulado/ajax-modal-estatisticas/	apps.autor.views.ajax_modal_estatisticas	aluno:simulado:ajax-modal-estatisticas	
/aluno/gabaritos-autocorrecao/	apps.aluno.views.gabarito_autocorrecao	aluno:gabaritos_autocorrecao	
/aluno/creditos/	apps.aluno.views.creditos	aluno:creditos	
/aluno/creditos/comprar/	apps.aluno.views.creditos_comprar	aluno:creditos_comprar	
/aluno/creditos/comprar/render/	apps.aluno.views.creditos_comprar_render	aluno:creditos_comprar_render	
/aluno/creditos/resgates/	apps.aluno.views.creditos_resgates	aluno:creditos_resgate	
/aluno/creditos/historico/	apps.aluno.views.creditos_historico	aluno:creditos_historico	
/aluno/gabaritos-autocorrecao/formulario/<pk>/	apps.aluno.views.gabarito_autocorrecao_formulario	aluno:gabaritos_autocorrecao_formulario	
/aluno/gabaritos-autocorrecao/formulario/<pk>/corrigir/	apps.aluno.views.gabarito_autocorrecao_formulario_corrigir	aluno:gabaritos_autocorrecao_formulario_corrigir	
/aluno/cupons/	apps.aluno.views.cupons	aluno:cupons	
/aluno/livros/	apps.aluno.views.livros	aluno:livros	
/aluno/baixar_livro/<lid>/	apps.aluno.views.baixar_livro	aluno:baixar-livro	
/aluno/certificado/	apps.aluno.views.certificado	aluno:certificado	
/aluno/certificado/solicitar/<cid>/	apps.aluno.views.certificado_solicitar	aluno:certificado-solicitar	
/aluno/sentencas-avulsas/	apps.aluno.views.sentencas_avulsas	aluno:sentencas-avulsas	
/aluno/sentencas-oab/	apps.aluno.views.sentencas_oab	aluno:sentencas-oab	
/aluno/cursos/video/<vid>/	apps.aluno.views.video	aluno:curso-video	
/aluno/cursos/discussao/<pk>/	apps.aluno.views.discussao	aluno:curso-discussao	
/aluno/perfil-aluno/<aid>/	apps.aluno.views.perfil_aluno	aluno:perfil-aluno	
/aluno/busca/	apps.aluno.views.busca_aluno	aluno:busca-aluno	
/aluno/notificacoes/	apps.aluno.views.notificacoes	aluno:notificacoes	
/aluno/timeline/	apps.aluno.views.timeline	aluno:timeline	
/aluno/mensagens/	apps.aluno.views.mensagens	aluno:mensagens	
/aluno/configuracoes/	apps.aluno.views.configuracoes	aluno:configuracoes	
/aluno/get_message/	apps.aluno.views.get_message	aluno:get_message	
/aluno/busca-aluno-json/	apps.aluno.views.busca_aluno_json	aluno:busca-aluno-json	
/aluno/cadastro/	apps.aluno.views.cadastro	aluno:cadastro	
/aluno/meus-desafios/	apps.aluno.views.meus_desafios	aluno:meus-desafios	
/autocorrecao/ajax_responder/	apps.formulario_auto_correcao.views.ajax_responder	autocorrecao:responder	
/autocorrecao/baixar_correcao/<pk>/	apps.formulario_auto_correcao.views.baixar_correcao	autocorrecao:baixar_correcao	
/aluno/quizz/<pk>/	apps.quizz.views.quizz	quizz:quizz	
/aluno/quizz/questao/<qpk>/<pk>/	apps.quizz.views.questao	quizz:questao	
/professor/	apps.professor.views.painel	professor:painel	
/professor/cursos/	apps.professor.views.cursos	professor:cursos	
/professor/sentencas/	apps.professor.views.sentencas	professor:sentencas	
/professor/sentencas/view/<pk>/	apps.professor.views.sentenca_view	professor:sentenca_view	
/professor/recursos/	apps.professor.views.recursos	professor:recursos	
/professor/sentencas-oab/	apps.professor.views.sentencas_oab	professor:sentencas-oab	
/professor/mensagens	apps.professor.views.mensagens	professor:mensagens	
/professor/mensagens/<pk>/	apps.professor.views.mensagens	professor:mensagens-curso	
/professor/get-message/	apps.professor.views.get_message	professor:get-message	
/professor/redigir-correcao/<pk>/	apps.professor.views.redigir_correcao	professor:redigir-correcao	
/professor/formulario-correcao/<pk>/	apps.professor.views.formulario_correcao	professor:formulario-correcao	
/professor/formulario-correcao-sentenca/<pk>/	apps.professor.views.formulario_correcao_sentenca	professor:formulario-correcao-sentenca	
/professor/get-sentenca-aluno/<pk>/	apps.professor.views.get_sentenca_aluno	professor:get-sentenca-aluno	
/professor/formulario-estatistica/	apps.professor.views.formulario_estatistica	professor:formulario-estatistica	
/professor/formulario-estatistica-geral/	apps.professor.views.formulario_estatistica_geral	professor:formulario-estatistica-geral	
/professor/formulario-recorrer/	apps.professor.views.formulario_recorrer	professor:formulario-recorrer	
/professor/formulario-estatistica-sentenca/	apps.professor.views.formulario_estatistica_sentenca	professor:formulario-estatistica-sentenca	
/professor/formulario-estatistica-correcao/	apps.professor.views.formulario_estatistica_correcao	professor:formulario-estatistica-correcao	
/professor/corecao-get-data/	apps.professor.views.correcao_get_data	professor:correcao-get-data	
/professor/post-salvar-tabela/	apps.professor.views.post_salvar_tabela	professor:post-salvar-tabela	
/professor/post-salvar-comentario/	apps.professor.views.salvar_comentario_professor	professor:post-salvar-comentario	
/professor/post-salvar-item/	apps.professor.views.salvar_item_recorrer	professor:post-salvar-item	
/professor/post-confirmar-recorer/	apps.professor.views.post_confirmar_recorrer	professor:post-confirmar-recorrer	
/corretor/cadastro/	apps.corretor.views.cadastro	corretor:cadastro	
/corretor/painel/	apps.corretor.views.painel	corretor:painel	
/corretor/pregao/	apps.corretor.views.pregao	corretor:pregao	
/curso/categoria/<slug>/	apps.curso.views.categoria	curso:categoria	
/curso/curso/<slug>/	apps.curso.views.curso	curso:curso	
/curso/montar-pacote/	apps.curso.views.montar_pacote	curso:montar-pacote	
/curso/relatorio/	apps.curso.views.relatorio	curso:relatorio	
/curso/sentenca/<slug>/	apps.curso.views.curso_sentenca	curso:curso-sentenca	
/curso/simulado/<slug>/	apps.curso.views.curso_sentenca	curso:curso-simulado	
/curso/simulados/	apps.curso.views.CursoSimuladoListView	curso:simulado-list	
/curso/oab/<slug>/	apps.curso.views.curso_sentenca	curso:curso-oab	
/curso/serie/<slug>/	apps.curso.views.serie	curso:serie	
/curso/curso-gratis/<slug>/	apps.curso.views.curso_gratis	curso:curso-gratis	
/curso/carrinho/	apps.curso.views.carrinho	curso:carrinho	
/curso/carrinho-pagamento/	apps.curso.views.carrinho_pagamento	curso:carrinho-pagamento	
/curso/get-payment-methods/	apps.curso.views.get_payment_methods	curso:get-payment-methods	
/curso/checkout/	apps.curso.views.checkout	curso:checkout	
/curso/trans/	apps.curso.views.trans	curso:trans	
/curso/get-tarefa-json/	apps.curso.views.get_tarefa_json	curso:get-tarefa-json	
/curso/get-alunos-curso-json/	apps.curso.views.get_alunos_curso_json	curso:get-alunos-curso-json	
/curso/get-amostra-json/	apps.curso.views.get_amostra_json	curso:get-amostra-json	
/curso/post-resposta/<pk>/	apps.curso.views.post_resposta	curso:post-resposta	
/curso/post-correcao/<pk>/	apps.curso.views.post_correcao	curso:post-correcao	
/curso/atividade/responder/<pk>/	apps.curso.views.atividade_responder	curso:atividade-responder	
/curso/atividade/imprimir/<pk>/	apps.curso.views.imprimir	curso:atividade-imprimir	
/curso/baixar/correcao/<pk>/	apps.curso.views.baixar_correcao	curso:baixar-correcao	
/curso/sentenca/responder/<pk>/	apps.curso.views.sentenca_responder	curso:sentenca-responder	
/curso/sentenca/imprimir/<pk>/	apps.curso.views.sentenca_imprimir	curso:sentenca-imprimir	
/curso/post-sentenca/<pk>/	apps.curso.views.post_sentenca	curso:post-sentenca	
/curso/pecas-oab/responder/<pk>/	apps.curso.views.sentenca_oab_responder	curso:sentenca-oab-responder	
/curso/post-sentenca-oab/<pk>/	apps.curso.views.post_sentenca_oab	curso:post-sentenca-oab	
/curso/download/tarefa/<pk>/	apps.curso.views.download_tarefa	curso:download-tarefa	
/curso/enviar/correcao/	apps.curso.views.enviar_correcao	curso:enviar-correcao	
/curso/enviar/resposta/padrao/	apps.curso.views.enviar_resposta_padrao	curso:enviar-resposta-padrao	
/curso/ajax-search-simulado	apps.curso.views.ajax_search_simulado	curso:ajax-search-simulado	
/curso/ajax-gerar-cortesia	apps.curso.views.ajax_gerar_cortesia	curso:ajax-gerar-cortesia	
/curso/ajax-validar-cortesia	apps.curso.views.ajax_validar_cortesia	curso:ajax-validar-cortesia	
/enunciado/<ptipo>/	apps.enunciado.views.tipo	enunciado:tipo	
/enunciado/<ptipo>/<pid>/	apps.enunciado.views.tipo	enunciado:tipo-id	
/enunciado/<ptipo>/<pid>/responder/	apps.enunciado.views.responder	enunciado:responder	
/enunciado/imprimir/<eid>/	apps.enunciado.views.imprimir	enunciado:imprimir	
/enunciado/resposta/<rid>/	apps.enunciado.views.resposta	enunciado:resposta	
/enunciado/socilitar-correcao/<rid>/	apps.enunciado.views.solicitar_correcao	enunciado:solicitar-correcao	
/enunciado/roteiros/	apps.enunciado.views.roteiros	enunciado:roteiros	
/enunciado/roteiro/<slug>/	apps.enunciado.views.roteiro	enunciado:roteiro	
/enunciado/roteiro/<slug>/<item_slug>/	apps.enunciado.views.roteiro_item	enunciado:roteiro-item	
/enunciado/roteiro/<slug>/<item_slug>/<sub_slug>/	apps.enunciado.views.roteiro_subitem	enunciado:roteiro-sub-item	
/enunciado/avaliar-correcao/	apps.enunciado.views.avaliar_correcao	enunciado:avaliar-correcao	
/enunciado/avaliar-resposta/<rid>/	apps.enunciado.views.avaliar_resposta	enunciado:avaliar-resposta	
/enunciado/correcao/<cid>/	apps.enunciado.views.correcao	enunciado:correcao	
/enunciado/atividade/	apps.enunciado.views.atividade	enunciado:atividade	
/enunciado/temas-abordados/	apps.enunciado.views.temas_abordados	enunciado:temas-abordados	
/enunciado/mais-populares/	apps.enunciado.views.mais_populares	enunciado:mais-populares	
/enunciado/resposta-desativar/<rid>/	apps.enunciado.views.resposta_desativar	enunciado:resposta-desativar	
/enunciado/resposta/<pid>/<cid>/	apps.enunciado.views.resposta	enunciado:correcao	
/enunciado/ranking/	apps.enunciado.views.ranking	enunciado:ranking	
/enunciado/ranking-premiado/	apps.enunciado.views.ranking_premiado	enunciado:ranking-premiado	
/enunciado/get_chart/	apps.enunciado.views.get_chart	enunciado:get-chart	
/enunciado/busca/	apps.enunciado.views.busca	enunciado:busca	
/enunciado/get/	apps.enunciado.views.obter	enunciado:obter	
/enunciado/salvar-resposta/	apps.enunciado.views.salvar_resposta	enunciado:salvar-resposta	
/enunciado/recentes/	apps.enunciado.views.recentes	enunciado:recentes	
/financeiro/teste/	apps.financeiro.views.teste	financeiro:teste	
/financeiro/get-credito/	apps.financeiro.views.get_credito	financeiro:get-credito	
/pagseguro/	apps.pagseguro.views.receive_notification	pagseguro:pagseguro_receive_notification	
/carrinho/	apps.curso.views.carrinho	carrinho	
/checkout/carrinho/	apps.checkout.views.CartView	checkout:cart	
/checkout/dados-pessoais/	apps.checkout.views.PersonalInfomationView	checkout:personal_information	
/checkout/pagar/	apps.checkout.views.PaymentView	checkout:payment	
/checkout/status/<code>/	apps.checkout.views.StatusView	checkout:status	
/checkout/ajax_cupom_actions/	apps.checkout.views.ajax_cupom_actions	checkout:ajax_cupom_actions	
/checkout/ajax_busca_cep/	apps.checkout.views.ajax_busca_cep	checkout:ajax_busca_cep	
/checkout/ajax_checkout/	apps.checkout.views.ajax_checkout	checkout:ajax_checkout	
/checkout/ajax_check_checkout/	apps.checkout.views.ajax_check_checkout	checkout:ajax_check_checkout	
/chaining/all/<app>/<model>/<field>/<foreign_key_app_name>/<foreign_key_model_name>/<foreign_key_field_name>/<value>/	smart_selects.views.filterchain_all	chained_filter_all	
/chaining/filter/<app>/<model>/<field>/<foreign_key_app_name>/<foreign_key_model_name>/<foreign_key_field_name>/<value>/	smart_selects.views.filterchain	chained_filter	
/chaining/filter/<app>/<model>/<manager>/<field>/<foreign_key_app_name>/<foreign_key_model_name>/<foreign_key_field_name>/<value>/	smart_selects.views.filterchain	chained_filter	
/select2/fields/auto.json	django_select2.views.AutoResponseView	django_select2-json	
/dajaxice/<var>/	dajaxice.views.DajaxiceRequest	dajaxice-call-endpoint	
/dajaxice/	dajaxice.views.DajaxiceRequest	dajaxice-endpoint	
/redactor/upload/image/<upload_to>	redactor.views.RedactorUploadView	redactor_upload_image	
/redactor/upload/file/<upload_to>	redactor.views.RedactorUploadView	redactor_upload_file	
/login/	django.contrib.auth.views.login	login	
/logout/	django.contrib.auth.views.logout	logout	
/accounts/register/closed/	django.views.generic.base.TemplateView	registration_disallowed	
/accounts/register/complete/	django.views.generic.base.TemplateView	registration_complete	
/accounts/register/	registration.backends.simple.views.RegistrationView	registration_register	
/accounts/login/	django.contrib.auth.views.login	auth_login	
/accounts/logout/	django.contrib.auth.views.logout	auth_logout	
/accounts/password/change/	django.contrib.auth.views.password_change	auth_password_change	
/accounts/password/change/done/	django.contrib.auth.views.password_change_done	auth_password_change_done	
/accounts/password/reset/	django.contrib.auth.views.password_reset	auth_password_reset	
/accounts/password/reset/complete/	django.contrib.auth.views.password_reset_complete	auth_password_reset_complete	
/accounts/password/reset/done/	django.contrib.auth.views.password_reset_done	auth_password_reset_done	
/accounts/password/reset/confirm/<uidb64>/<token>/	django.contrib.auth.views.password_reset_confirm	auth_password_reset_confirm	
/accounts/signup/	allauth.account.views.SignupView	account_signup	
/accounts/login/	allauth.account.views.LoginView	account_login	
/accounts/logout/	allauth.account.views.LogoutView	account_logout	
/accounts/password/change/	allauth.account.views.PasswordChangeView	account_change_password	
/accounts/password/set/	allauth.account.views.PasswordSetView	account_set_password	
/accounts/inactive/	allauth.account.views.AccountInactiveView	account_inactive	
/accounts/email/	allauth.account.views.EmailView	account_email	
/accounts/confirm-email/	allauth.account.views.EmailVerificationSentView	account_email_verification_sent	
/accounts/confirm-email/<key>/	allauth.account.views.ConfirmEmailView	account_confirm_email	
/accounts/password/reset/	allauth.account.views.PasswordResetView	account_reset_password	
/accounts/password/reset/done/	allauth.account.views.PasswordResetDoneView	account_reset_password_done	
/accounts/password/reset/key/<uidb36>-<key>/	allauth.account.views.PasswordResetFromKeyView	account_reset_password_from_key	
/accounts/password/reset/key/done/	allauth.account.views.PasswordResetFromKeyDoneView	account_reset_password_from_key_done	
/accounts/social/login/cancelled/	allauth.socialaccount.views.LoginCancelledView	socialaccount_login_cancelled	
/accounts/social/login/error/	allauth.socialaccount.views.LoginErrorView	socialaccount_login_error	
/accounts/social/signup/	allauth.socialaccount.views.SignupView	socialaccount_signup	
/accounts/social/connections/	allauth.socialaccount.views.ConnectionsView	socialaccount_connections	
/accounts/facebook/login/	allauth.socialaccount.providers.oauth2.views.view	facebook_login	
/accounts/facebook/login/callback/	allauth.socialaccount.providers.oauth2.views.view	facebook_callback	
/accounts/facebook/login/token/	allauth.socialaccount.providers.facebook.views.login_by_token	facebook_login_by_token	
/comments/post/	django_comments.views.comments.post_comment	comments-post-comment	
/comments/posted/	django_comments.views.utils.confirmed	comments-comment-done	
/comments/flag/<var>/	django_comments.views.moderation.flag	comments-flag	
/comments/flagged/	django_comments.views.utils.confirmed	comments-flag-done	
/comments/delete/<var>/	django_comments.views.moderation.delete	comments-delete	
/comments/deleted/	django_comments.views.utils.confirmed	comments-delete-done	
/comments/approve/<var>/	django_comments.views.moderation.approve	comments-approve	
/comments/approved/	django_comments.views.utils.confirmed	comments-approve-done	
/comments/cr/<var>/<var>/	django.contrib.contenttypes.views.shortcut	comments-url-redirect	
/filer/arquivos/<uploaded_at>/<file_id>/	filer.views.canonical	canonical	
/smedia/filer_private/<path>	filer.server.views.serve_protected_file		
/smedia/filer_private_thumbnails/<path>	filer.server.views.serve_protected_thumbnail		
/_nested_admin/server-data.js	nested_admin.views.server_data_js	nesting_server_data	
